//MAP CONVERTED BY dmm2tgm.py THIS HEADER COMMENT PREVENTS RECONVERSION, DO NOT REMOVE
"aG" = (
/obj/structure/window/reinforced{
	dir = 1
	},
/obj/structure/window/reinforced{
	dir = 8
	},
/obj/structure/cable,
/obj/structure/shuttle/engine/heater,
/turf/open/floor/iron/shuttle/cargo,
/area/shuttle/supply)
"bb" = (
/obj/structure/shuttle/engine/propulsion/left,
/turf/open/floor/iron/shuttle/cargo,
/area/shuttle/supply)
"bx" = (
/obj/effect/turf_decal/box,
/obj/machinery/atmospherics/pipe/smart/manifold4w/scrubbers/hidden/layer2,
/obj/structure/cable,
/turf/open/floor/iron/shuttle/ferry{
	icon_state = "sign_2"
	},
/area/shuttle/supply)
"bW" = (
/obj/effect/turf_decal/stripes/line{
	dir = 4
	},
/turf/open/floor/noslip,
/area/shuttle/supply)
"bX" = (
/turf/closed/wall/mineral/titanium/shuttle_wall/arrivals{
	icon_state = "12,1"
	},
/area/shuttle/supply)
"cw" = (
/turf/closed/wall/mineral/titanium/shuttle_wall/arrivals{
	icon_state = "0,4"
	},
/area/shuttle/supply)
"eN" = (
/turf/closed/wall/mineral/titanium/shuttle_wall/window/arrivals{
	icon_state = "8,4"
	},
/area/shuttle/supply)
"fV" = (
/obj/effect/turf_decal/stripes/red/line{
	dir = 8
	},
/turf/open/floor/iron/shuttle/cargo,
/area/shuttle/supply)
"gd" = (
/turf/closed/wall/mineral/titanium/shuttle_wall/window/arrivals{
	icon_state = "4,4"
	},
/area/shuttle/supply)
"gg" = (
/obj/structure/shuttle/engine/heater,
/obj/structure/window/reinforced{
	dir = 1
	},
/turf/open/floor/iron/shuttle/cargo,
/area/shuttle/supply)
"gt" = (
/turf/closed/wall/mineral/titanium/shuttle_wall/arrivals{
	icon_state = "2,4"
	},
/area/shuttle/supply)
"hd" = (
/turf/closed/wall/mineral/titanium/shuttle_wall/arrivals{
	icon_state = "3,4"
	},
/area/shuttle/supply)
"hp" = (
/obj/machinery/atmospherics/pipe/smart/manifold4w/supply/hidden/layer4,
/obj/machinery/door/airlock/grunge{
	name = "Supply Shuttle Airlock";
	req_access_txt = "31"
	},
/obj/effect/mapping_helpers/airlock/access/all/supply/general,
/obj/docking_port/mobile/supply{
	dir = 1;
	dwidth = 4
	},
/obj/structure/cable,
/turf/open/floor/iron/shuttle/cargo,
/area/shuttle/supply)
"hG" = (
/turf/template_noop,
/area/template_noop)
"ic" = (
/obj/structure/shuttle/engine/propulsion/left,
/obj/structure/window/reinforced{
	dir = 4
	},
/turf/open/floor/iron/shuttle/cargo,
/area/shuttle/supply)
"iI" = (
/obj/effect/turf_decal/stripes/red/line{
	dir = 8
	},
/obj/effect/turf_decal/stripes/line{
	dir = 4
	},
/obj/machinery/atmospherics/pipe/smart/manifold4w/supply/hidden/layer4,
/obj/structure/cable,
/turf/open/floor/noslip,
/area/shuttle/supply)
"iX" = (
/obj/machinery/atmospherics/pipe/smart/manifold4w/scrubbers/hidden/layer2,
/turf/open/floor/iron/shuttle/ferry{
	dir = 8;
	icon_state = "floor"
	},
/area/shuttle/supply)
"iY" = (
/turf/closed/wall/mineral/titanium/shuttle_wall/arrivals{
	icon_state = "12,4"
	},
/area/shuttle/supply)
"jo" = (
/obj/effect/turf_decal/stripes/line{
	dir = 8
	},
/turf/open/floor/noslip,
/area/shuttle/supply)
"jO" = (
/turf/closed/wall/mineral/titanium/shuttle_wall/arrivals{
	icon_state = "0,2"
	},
/area/shuttle/supply)
"jW" = (
/obj/machinery/atmospherics/pipe/smart/manifold4w/scrubbers/hidden/layer2,
/obj/structure/cable,
/turf/open/floor/iron/shuttle/ferry{
	dir = 8;
	icon_state = "floor"
	},
/area/shuttle/supply)
"kI" = (
/turf/open/floor/iron/half,
/area/shuttle/supply)
"ly" = (
/obj/effect/turf_decal/stripes/red/line,
/obj/effect/decal/cleanable/dirt,
/obj/machinery/atmospherics/pipe/smart/manifold4w/supply/hidden/layer4,
/turf/open/floor/iron/shuttle/ferry{
	dir = 8;
	icon_state = "floor"
	},
/area/shuttle/supply)
"lO" = (
/obj/effect/turf_decal/box,
/turf/open/floor/iron/shuttle/ferry{
	icon_state = "sign_2"
	},
/area/shuttle/supply)
"mx" = (
/obj/effect/turf_decal/stripes/red/corner{
	dir = 8
	},
/obj/effect/decal/cleanable/dirt,
/turf/open/floor/iron/shuttle/cargo{
	icon_state = "floor_mainta"
	},
/area/shuttle/supply)
"nH" = (
/obj/effect/decal/cleanable/oil/streak,
/obj/machinery/atmospherics/pipe/smart/manifold4w/supply/hidden/layer4,
/obj/structure/cable,
/turf/open/floor/iron/shuttle/ferry{
	icon_state = "sign_2"
	},
/area/shuttle/supply)
"nJ" = (
/obj/structure/table/reinforced,
/obj/effect/decal/cleanable/confetti,
/turf/open/floor/iron/sepia,
/area/shuttle/supply)
"nP" = (
/turf/closed/wall/mineral/titanium/shuttle_wall/arrivals{
	icon_state = "12,3"
	},
/area/shuttle/supply)
"nZ" = (
/obj/effect/turf_decal/stripes/line{
	dir = 4
	},
/obj/structure/cable,
/turf/open/floor/noslip,
/area/shuttle/supply)
"oj" = (
/obj/effect/turf_decal/box,
/obj/machinery/atmospherics/pipe/smart/manifold4w/supply/hidden/layer4,
/obj/structure/cable,
/turf/open/floor/iron/shuttle/ferry{
	icon_state = "sign_2"
	},
/area/shuttle/supply)
"on" = (
/obj/effect/turf_decal/stripes/red/corner{
	dir = 8
	},
/obj/effect/turf_decal/stripes/line{
	dir = 4
	},
/obj/structure/cable,
/turf/open/floor/noslip,
/area/shuttle/supply)
"ou" = (
/obj/machinery/atmospherics/pipe/smart/manifold4w/supply/hidden/layer4,
/obj/machinery/door/airlock/grunge{
	name = "Supply Shuttle Cockpit";
	req_access_txt = "31"
	},
/obj/effect/mapping_helpers/airlock/access/all/cent_com,
/turf/open/floor/iron/sepia,
/area/shuttle/supply)
"oS" = (
/obj/machinery/conveyor/inverted{
	id = "cargoload"
	},
/obj/machinery/door/poddoor{
	id = "QMLoaddoor";
	name = "supply dock loading door"
	},
/turf/open/floor/iron/sepia,
/area/shuttle/supply)
"pz" = (
/obj/structure/shuttle/engine/propulsion/right,
/obj/structure/window/reinforced{
	dir = 8
	},
/turf/open/floor/iron/shuttle/cargo,
/area/shuttle/supply)
"qK" = (
/turf/closed/wall/mineral/titanium/shuttle_wall/arrivals{
	icon_state = "3,3"
	},
/area/shuttle/supply)
"qM" = (
/turf/closed/wall/mineral/titanium/shuttle_wall/arrivals{
	icon_state = "12,2"
	},
/area/shuttle/supply)
"ra" = (
/obj/structure/chair/comfy/shuttle{
	dir = 1
	},
/obj/effect/decal/cleanable/confetti,
/obj/machinery/atmospherics/components/unary/vent_pump/on/layer4{
	dir = 8
	},
/turf/open/floor/iron/sepia,
/area/shuttle/supply)
"rf" = (
/turf/closed/wall/mineral/titanium/shuttle_wall/arrivals{
	icon_state = "11,4"
	},
/area/shuttle/supply)
"rx" = (
/obj/machinery/atmospherics/pipe/smart/manifold4w/supply/hidden/layer4,
/obj/effect/turf_decal/stripes/line{
	dir = 4
	},
/turf/open/floor/iron/shuttle/ferry,
/area/shuttle/supply)
"rU" = (
/turf/closed/wall/mineral/titanium/shuttle_wall/arrivals{
	icon_state = "0,1"
	},
/area/shuttle/supply)
"sH" = (
/turf/closed/wall/mineral/titanium/shuttle_wall/arrivals{
	icon_state = "6,4"
	},
/area/shuttle/supply)
"sJ" = (
/obj/machinery/computer{
	desc = "This WAS a helmsman's console, before it became a coffee's console."
	},
/obj/effect/decal/cleanable/confetti,
/turf/open/floor/iron/sepia,
/area/shuttle/supply)
"uR" = (
/obj/structure/chair/comfy/shuttle{
	dir = 1
	},
/obj/effect/decal/cleanable/dirt,
/obj/effect/decal/cleanable/food/tomato_smudge,
/obj/effect/decal/cleanable/confetti,
/turf/open/floor/iron/sepia,
/area/shuttle/supply)
"vP" = (
/turf/closed/wall/mineral/titanium/shuttle_wall/arrivals{
	icon_state = "9,3"
	},
/area/shuttle/supply)
"wc" = (
/turf/closed/wall/mineral/titanium/shuttle_wall/arrivals{
	icon_state = "11,3"
	},
/area/shuttle/supply)
"wh" = (
/obj/effect/turf_decal/stripes/line{
	dir = 8
	},
/obj/structure/cable,
/turf/open/floor/noslip,
/area/shuttle/supply)
"xu" = (
/turf/closed/wall/mineral/titanium/interior,
/area/shuttle/supply)
"xM" = (
/turf/closed/wall/mineral/titanium/shuttle_wall/arrivals{
	icon_state = "0,0"
	},
/area/shuttle/supply)
"yb" = (
/obj/machinery/atmospherics/pipe/smart/manifold4w/supply/hidden/layer4,
/turf/open/floor/iron/shuttle/cargo{
	icon_state = "floor_maintb"
	},
/area/shuttle/supply)
"zt" = (
/obj/effect/turf_decal/stripes/red/line{
	dir = 4
	},
/turf/open/floor/iron/shuttle/cargo,
/area/shuttle/supply)
"Ah" = (
/obj/effect/turf_decal/box,
/obj/effect/decal/cleanable/dirt,
/turf/open/floor/iron/shuttle/ferry{
	icon_state = "sign_2"
	},
/area/shuttle/supply)
"Ar" = (
/obj/effect/turf_decal/box,
/obj/structure/cable,
/turf/open/floor/iron/shuttle/ferry{
	icon_state = "sign_2"
	},
/area/shuttle/supply)
"Bh" = (
/obj/machinery/atmospherics/pipe/smart/manifold4w/scrubbers/hidden/layer2,
/obj/effect/turf_decal/stripes/line{
	dir = 8
	},
/turf/open/floor/iron/shuttle/ferry,
/area/shuttle/supply)
"BC" = (
/obj/effect/spawner/structure/window/reinforced/shuttle,
/turf/open/floor/plating,
/area/shuttle/supply)
"BP" = (
/obj/structure/chair/comfy/shuttle{
	dir = 1
	},
/obj/effect/decal/cleanable/confetti,
/obj/machinery/atmospherics/components/unary/vent_scrubber/on/layer2{
	dir = 4
	},
/turf/open/floor/iron/sepia,
/area/shuttle/supply)
"Ci" = (
/obj/machinery/atmospherics/pipe/smart/manifold4w/scrubbers/hidden/layer2,
/obj/effect/turf_decal/stripes/corner{
	dir = 1
	},
/obj/machinery/light/red/directional/east,
/turf/open/floor/iron/shuttle/ferry{
	icon_state = "sign_2"
	},
/area/shuttle/supply)
"DW" = (
/obj/effect/spawner/structure/window/reinforced/shuttle,
/turf/open/floor/iron/shuttle/cargo,
/area/shuttle/supply)
"Fq" = (
/obj/structure/sign/nanotrasen,
/turf/closed/wall/mineral/titanium/shuttle_wall/arrivals,
/area/shuttle/supply)
"FQ" = (
/obj/machinery/atmospherics/pipe/smart/manifold4w/scrubbers/hidden/layer2,
/obj/machinery/door/airlock/grunge{
	name = "Supply Shuttle Cockpit";
	req_access_txt = "31"
	},
/obj/effect/mapping_helpers/airlock/access/all/cent_com,
/turf/open/floor/iron/sepia,
/area/shuttle/supply)
"GA" = (
/obj/machinery/atmospherics/pipe/smart/manifold4w/scrubbers/hidden/layer2,
/obj/effect/decal/cleanable/dirt,
/obj/effect/turf_decal/stripes/line{
	dir = 8
	},
/turf/open/floor/iron/shuttle/ferry,
/area/shuttle/supply)
"Ht" = (
/obj/machinery/atmospherics/pipe/smart/manifold4w/supply/hidden/layer4,
/obj/effect/turf_decal/stripes/corner{
	dir = 4
	},
/obj/machinery/light/red/directional/west,
/turf/open/floor/iron/shuttle/ferry{
	icon_state = "sign_2"
	},
/area/shuttle/supply)
"HD" = (
/obj/machinery/status_display/supply{
	pixel_y = 32
	},
/obj/effect/decal/cleanable/oil/slippery,
/obj/effect/turf_decal/stripes/line{
	dir = 5
	},
/turf/open/floor/noslip,
/area/shuttle/supply)
"Is" = (
/obj/machinery/atmospherics/components/unary/vent_scrubber/on/layer2,
/obj/effect/decal/cleanable/cum,
/obj/effect/decal/cleanable/blood/old,
/obj/structure/cable,
/obj/machinery/power/apc/ten_k/directional/north,
/turf/open/floor/iron/shuttle/cargo,
/area/shuttle/supply)
"IX" = (
/obj/machinery/atmospherics/pipe/smart/manifold4w/scrubbers/hidden/layer2,
/obj/effect/decal/cleanable/vomit,
/turf/open/floor/iron/shuttle/cargo{
	icon_state = "floor_maintb"
	},
/area/shuttle/supply)
"Jg" = (
/obj/effect/turf_decal/box,
/obj/effect/decal/cleanable/generic,
/turf/open/floor/iron/shuttle/ferry{
	icon_state = "sign_2"
	},
/area/shuttle/supply)
"KS" = (
/obj/structure/shuttle/engine/propulsion/right,
/turf/open/floor/iron/shuttle/cargo,
/area/shuttle/supply)
"Lj" = (
/obj/machinery/status_display/supply{
	pixel_y = 32
	},
/obj/effect/decal/cleanable/dirt,
/obj/effect/turf_decal/stripes/line{
	dir = 9
	},
/turf/open/floor/noslip,
/area/shuttle/supply)
"LF" = (
/turf/closed/wall/mineral/titanium/shuttle_wall/arrivals,
/area/shuttle/supply)
"LI" = (
/obj/effect/turf_decal/box,
/obj/effect/decal/cleanable/dirt,
/obj/effect/decal/cleanable/dirt,
/obj/effect/decal/cleanable/oil/slippery,
/obj/structure/cable,
/turf/open/floor/iron/shuttle/ferry{
	icon_state = "sign_2"
	},
/area/shuttle/supply)
"LM" = (
/obj/machinery/conveyor{
	id = "cargounload"
	},
/obj/machinery/door/poddoor{
	id = "QMLoaddoor2";
	name = "supply dock loading door"
	},
/turf/open/floor/iron/sepia,
/area/shuttle/supply)
"Mb" = (
/obj/machinery/atmospherics/pipe/smart/manifold4w/scrubbers/hidden/layer2,
/obj/effect/decal/cleanable/blood/footprints,
/turf/open/floor/iron/shuttle/ferry{
	dir = 8;
	icon_state = "floor"
	},
/area/shuttle/supply)
"Nh" = (
/obj/machinery/conveyor/inverted{
	id = "cargoload"
	},
/obj/structure/cable,
/turf/open/floor/iron/sepia,
/area/shuttle/supply)
"Oh" = (
/obj/effect/turf_decal/stripes/red/corner,
/turf/open/floor/iron/shuttle/cargo{
	icon_state = "floor_mainta"
	},
/area/shuttle/supply)
"OB" = (
/obj/machinery/atmospherics/pipe/smart/manifold4w/scrubbers/hidden/layer2,
/obj/machinery/door/airlock/grunge{
	name = "Supply Shuttle Airlock";
	req_access_txt = "31"
	},
/obj/effect/mapping_helpers/airlock/access/all/supply/general,
/obj/structure/cable,
/turf/open/floor/iron/shuttle/cargo,
/area/shuttle/supply)
"OV" = (
/obj/machinery/atmospherics/components/unary/vent_pump/on/layer4,
/obj/machinery/airalarm/directional/north,
/obj/effect/decal/cleanable/cobweb,
/turf/open/floor/iron/shuttle/cargo,
/area/shuttle/supply)
"PB" = (
/obj/effect/decal/cleanable/dirt,
/turf/open/floor/iron/half,
/area/shuttle/supply)
"PW" = (
/turf/closed/wall/mineral/titanium/shuttle_wall/arrivals{
	icon_state = "0,3"
	},
/area/shuttle/supply)
"Ra" = (
/turf/closed/wall/mineral/titanium/shuttle_wall/arrivals{
	icon_state = "12,0"
	},
/area/shuttle/supply)
"RD" = (
/obj/effect/turf_decal/stripes/red/corner,
/obj/effect/turf_decal/stripes/line{
	dir = 8
	},
/obj/structure/cable,
/turf/open/floor/noslip,
/area/shuttle/supply)
"Sb" = (
/obj/effect/turf_decal/stripes/red/line,
/obj/effect/decal/cleanable/dirt,
/obj/effect/decal/cleanable/blood/tracks,
/obj/machinery/atmospherics/pipe/smart/manifold4w/scrubbers/hidden/layer2,
/turf/open/floor/iron/shuttle/ferry{
	dir = 8;
	icon_state = "floor"
	},
/area/shuttle/supply)
"TY" = (
/turf/closed/wall/mineral/titanium/shuttle_wall/arrivals{
	icon_state = "1,3"
	},
/area/shuttle/supply)
"UG" = (
/obj/structure/window/reinforced{
	dir = 4
	},
/obj/structure/window/reinforced{
	dir = 1
	},
/obj/structure/cable,
/obj/structure/shuttle/engine/heater,
/turf/open/floor/iron/shuttle/cargo,
/area/shuttle/supply)
"UM" = (
/obj/effect/turf_decal/stripes/red/line{
	dir = 4
	},
/obj/effect/turf_decal/stripes/line{
	dir = 8
	},
/obj/machinery/atmospherics/pipe/smart/manifold4w/scrubbers/hidden/layer2,
/obj/structure/cable,
/turf/open/floor/noslip,
/area/shuttle/supply)
"VM" = (
/obj/effect/decal/cleanable/oil/slippery,
/obj/effect/decal/cleanable/blood/tracks,
/obj/machinery/atmospherics/pipe/smart/manifold4w/scrubbers/hidden/layer2,
/obj/structure/cable,
/turf/open/floor/iron/shuttle/ferry{
	icon_state = "sign_2"
	},
/area/shuttle/supply)
"VU" = (
/obj/machinery/conveyor{
	id = "cargounload"
	},
/obj/structure/cable,
/turf/open/floor/iron/shuttle/ferry{
	dir = 8;
	icon_state = "floor"
	},
/area/shuttle/supply)
"XL" = (
/obj/machinery/button/door/directional/east{
	id = "QMLoaddoor2";
	name = "Loading Doors";
	pixel_x = -24
	},
/obj/machinery/atmospherics/pipe/smart/manifold4w/scrubbers/hidden/layer2,
/obj/effect/turf_decal/stripes/red/line{
	dir = 8
	},
/obj/machinery/light/red/directional/east,
/obj/structure/cable,
/turf/open/floor/iron/shuttle/cargo{
	dir = 8;
	icon_state = "floor_out"
	},
/area/shuttle/supply)
"Yy" = (
/obj/machinery/button/door/directional/east{
	id = "QMLoaddoor";
	name = "Loading Doors"
	},
/obj/machinery/atmospherics/pipe/smart/manifold4w/supply/hidden/layer4,
/obj/effect/turf_decal/stripes/red/line{
	dir = 4
	},
/obj/machinery/light/red/directional/west,
/obj/structure/cable,
/turf/open/floor/iron/shuttle/cargo{
	dir = 8;
	icon_state = "floor_in"
	},
/area/shuttle/supply)
"Za" = (
/turf/closed/wall/mineral/titanium/shuttle_wall/arrivals{
	icon_state = "1,4"
	},
/area/shuttle/supply)
"ZL" = (
/obj/machinery/atmospherics/pipe/smart/manifold4w/supply/hidden/layer4,
/turf/open/floor/iron/shuttle/ferry{
	dir = 8;
	icon_state = "floor"
	},
/area/shuttle/supply)

(1,1,1) = {"
hG
hG
hG
hG
cw
PW
BC
BC
jO
rU
LF
xM
"}
(2,1,1) = {"
cw
PW
jO
rU
Fq
LF
OV
yb
Oh
zt
gg
bb
"}
(3,1,1) = {"
Za
TY
rx
rx
Ht
ZL
ZL
ZL
ly
nH
UG
ic
"}
(4,1,1) = {"
gt
qK
ou
xu
HD
bW
nZ
nZ
on
iI
Nh
oS
"}
(5,1,1) = {"
eN
nJ
ra
DW
lO
kI
LI
lO
PB
oj
Yy
hp
"}
(6,1,1) = {"
sH
sJ
uR
DW
Jg
kI
Ar
Ah
PB
lO
LF
LF
"}
(7,1,1) = {"
gd
nJ
BP
DW
lO
kI
Ar
lO
PB
bx
XL
OB
"}
(8,1,1) = {"
hd
vP
FQ
xu
Lj
jo
wh
wh
RD
UM
VU
LM
"}
(9,1,1) = {"
rf
wc
Bh
GA
Ci
iX
jW
Mb
Sb
VM
aG
pz
"}
(10,1,1) = {"
iY
nP
qM
bX
Fq
LF
Is
IX
mx
fV
gg
KS
"}
(11,1,1) = {"
hG
hG
hG
hG
iY
nP
BC
BC
qM
bX
LF
Ra
"}
