//MAP CONVERTED BY dmm2tgm.py THIS HEADER COMMENT PREVENTS RECONVERSION, DO NOT REMOVE
"a" = (
/obj/effect/light_emitter{
	set_cap = 1;
	set_luminosity = 4
	},
/turf/open/misc/ironsand,
/area/centcom/interlink)
"b" = (
/obj/structure/railing/corner{
	dir = 4
	},
/obj/effect/turf_decal/trimline/blue/filled/arrow_cw,
/obj/effect/turf_decal/trimline/white/line,
/turf/open/floor/iron,
/area/centcom/interlink)
"c" = (
/obj/effect/turf_decal/trimline/blue/filled/arrow_ccw{
	dir = 1
	},
/obj/effect/turf_decal/trimline/white/line{
	dir = 1
	},
/turf/open/floor/iron,
/area/centcom/interlink)
"d" = (
/obj/effect/light_emitter{
	set_cap = 1;
	set_luminosity = 4
	},
/obj/effect/turf_decal/stripes/line{
	dir = 4
	},
/turf/open/misc/ironsand,
/area/centcom/interlink)
"f" = (
/obj/effect/turf_decal/trimline/blue/filled/line,
/obj/effect/turf_decal/trimline/white/arrow_cw,
/turf/open/floor/iron,
/area/centcom/interlink)
"g" = (
/obj/effect/turf_decal/stripes/line,
/obj/structure/window/reinforced/spawner/north,
/obj/structure/window/reinforced/spawner/west,
/obj/machinery/vending/clothing,
/turf/open/floor/iron,
/area/centcom/interlink)
"h" = (
/obj/structure/table,
/obj/item/lighter,
/turf/open/floor/iron,
/area/centcom/interlink)
"i" = (
/obj/machinery/computer/shuttle/arrivals/recall{
	dir = 4
	},
/turf/open/floor/iron,
/area/centcom/interlink)
"j" = (
/obj/effect/turf_decal/stripes/line,
/turf/open/floor/plating/cobblestone,
/area/centcom/interlink)
"k" = (
/obj/effect/turf_decal/trimline/blue/filled/line{
	dir = 1
	},
/obj/effect/turf_decal/trimline/white/arrow_ccw{
	dir = 1
	},
/turf/open/floor/iron,
/area/centcom/interlink)
"l" = (
/obj/machinery/door/airlock/engineering,
/obj/effect/turf_decal/trimline/blue/filled/arrow_cw,
/turf/open/floor/iron,
/area/centcom/interlink)
"m" = (
/turf/closed/indestructible/riveted,
/area/centcom/interlink)
"n" = (
/obj/machinery/door/airlock/engineering,
/obj/effect/turf_decal/trimline/blue/filled/arrow_ccw{
	dir = 1
	},
/turf/open/floor/iron,
/area/centcom/interlink)
"o" = (
/obj/structure/window/reinforced/spawner/west,
/obj/structure/railing/corner{
	dir = 4
	},
/obj/effect/turf_decal/trimline/blue/filled/corner,
/obj/effect/turf_decal/trimline/white/corner,
/turf/open/floor/iron,
/area/centcom/interlink)
"p" = (
/turf/open/floor/iron/dark/small,
/area/centcom/interlink)
"q" = (
/obj/effect/spawner/random/vending/colavend,
/turf/open/floor/iron,
/area/centcom/interlink)
"r" = (
/obj/effect/turf_decal/stripes/line,
/obj/structure/window/reinforced/spawner/north,
/obj/structure/window/reinforced/spawner/east,
/obj/machinery/vending/coffee,
/turf/open/floor/iron,
/area/centcom/interlink)
"s" = (
/obj/structure/window/reinforced/spawner/west,
/obj/effect/turf_decal/trimline/blue/filled/corner{
	dir = 4
	},
/obj/effect/turf_decal/trimline/white/corner{
	dir = 4
	},
/turf/open/floor/iron,
/area/centcom/interlink)
"t" = (
/obj/effect/turf_decal/trimline/white/arrow_cw,
/obj/effect/turf_decal/trimline/blue/filled/shrink_ccw,
/turf/open/floor/iron,
/area/centcom/interlink)
"v" = (
/obj/effect/turf_decal/trimline/blue/filled/arrow_cw,
/obj/effect/turf_decal/trimline/white/line,
/turf/open/floor/iron,
/area/centcom/interlink)
"w" = (
/obj/effect/turf_decal/stripes/line,
/obj/structure/window/reinforced/spawner/north,
/obj/structure/window/reinforced/spawner/west,
/obj/structure/window/reinforced/spawner/east,
/obj/item/kirbyplants/random,
/turf/open/floor/iron,
/area/centcom/interlink)
"A" = (
/obj/machinery/light/directional/south,
/obj/effect/turf_decal/trimline/blue/filled/arrow_ccw{
	dir = 1
	},
/obj/effect/turf_decal/trimline/white/line{
	dir = 1
	},
/turf/open/floor/iron,
/area/centcom/interlink)
"C" = (
/turf/open/floor/iron/smooth_half,
/area/centcom/interlink)
"E" = (
/obj/structure/railing/corner{
	dir = 1
	},
/obj/effect/turf_decal/trimline/blue/filled/arrow_cw,
/obj/effect/turf_decal/trimline/white/line,
/turf/open/floor/iron,
/area/centcom/interlink)
"F" = (
/obj/effect/turf_decal/stripes/line{
	dir = 4
	},
/obj/effect/light_emitter{
	set_cap = 1;
	set_luminosity = 4
	},
/turf/open/misc/ironsand,
/area/centcom/interlink)
"G" = (
/obj/effect/turf_decal/stripes/line,
/obj/structure/window/reinforced/spawner/north,
/obj/machinery/vending/snack/blue,
/turf/open/floor/iron,
/area/centcom/interlink)
"H" = (
/obj/effect/turf_decal/tile/blue/fourcorners,
/obj/effect/turf_decal/trimline/white/arrow_cw{
	dir = 10
	},
/obj/effect/turf_decal/trimline/white/line,
/turf/open/floor/iron,
/area/centcom/interlink)
"J" = (
/obj/effect/turf_decal/stripes/line,
/obj/structure/window/reinforced/spawner/north,
/obj/structure/window/reinforced/spawner/west,
/obj/item/kirbyplants/random,
/turf/open/floor/iron,
/area/centcom/interlink)
"L" = (
/obj/structure/sign/poster/contraband/random/directional/south,
/obj/effect/turf_decal/trimline/white/arrow_ccw{
	dir = 1
	},
/obj/effect/turf_decal/trimline/blue/filled/shrink_cw{
	dir = 1
	},
/turf/open/floor/iron,
/area/centcom/interlink)
"M" = (
/obj/effect/spawner/structure/window/reinforced,
/turf/open/floor/plating,
/area/centcom/interlink)
"N" = (
/obj/item/kirbyplants/random,
/turf/open/floor/iron,
/area/centcom/interlink)
"O" = (
/obj/docking_port/stationary{
	dir = 8;
	dwidth = 1;
	height = 13;
	id = "arrivals_shuttle";
	name = "tram dock";
	roundstart_template = /datum/map_template/shuttle/arrivals_skyrat;
	width = 7
	},
/turf/open/floor/iron/smooth_half,
/area/centcom/interlink)
"P" = (
/obj/effect/turf_decal/stripes/line,
/obj/structure/window/reinforced/spawner/north,
/obj/machinery/vending/cigarette,
/turf/open/floor/iron,
/area/centcom/interlink)
"Q" = (
/turf/open/floor/plating/cobblestone,
/area/centcom/interlink)
"R" = (
/obj/effect/turf_decal/stripes/line,
/obj/structure/window/reinforced/spawner/north,
/turf/open/floor/iron,
/area/centcom/interlink)
"U" = (
/obj/structure/flora/bush/flowers_yw,
/obj/effect/light_emitter{
	set_cap = 1;
	set_luminosity = 4
	},
/turf/open/misc/ironsand,
/area/centcom/interlink)
"V" = (
/obj/machinery/status_display/shuttle{
	pixel_y = -32;
	shuttle_id = "arrivals_shuttle"
	},
/obj/effect/turf_decal/trimline/blue/filled/arrow_ccw{
	dir = 1
	},
/obj/effect/turf_decal/trimline/white/line{
	dir = 1
	},
/turf/open/floor/iron,
/area/centcom/interlink)
"W" = (
/obj/effect/turf_decal/stripes/line,
/obj/structure/window/reinforced/spawner/north,
/obj/item/kirbyplants/random,
/turf/open/floor/iron,
/area/centcom/interlink)
"X" = (
/obj/effect/turf_decal/tile/blue/fourcorners,
/obj/effect/turf_decal/trimline/white/arrow_cw{
	dir = 8
	},
/obj/machinery/door/airlock/external/glass,
/turf/open/floor/iron,
/area/centcom/interlink)
"Z" = (
/obj/machinery/light/directional/south,
/obj/effect/turf_decal/trimline/blue/filled/line{
	dir = 1
	},
/obj/effect/turf_decal/trimline/white/arrow_ccw{
	dir = 1
	},
/turf/open/floor/iron,
/area/centcom/interlink)

(1,1,1) = {"
m
F
d
F
d
F
F
F
F
a
a
m
"}
(2,1,1) = {"
m
Q
C
Q
Q
Q
C
Q
j
U
a
m
"}
(3,1,1) = {"
m
Q
p
Q
Q
Q
p
Q
w
o
s
m
"}
(4,1,1) = {"
m
Q
C
Q
Q
Q
C
Q
X
H
k
M
"}
(5,1,1) = {"
m
Q
C
Q
Q
Q
C
Q
g
E
c
M
"}
(6,1,1) = {"
m
Q
C
Q
Q
Q
C
Q
P
f
Z
M
"}
(7,1,1) = {"
m
Q
C
Q
Q
Q
C
Q
R
v
c
M
"}
(8,1,1) = {"
m
Q
p
Q
Q
Q
p
Q
W
f
k
m
"}
(9,1,1) = {"
m
Q
C
Q
Q
Q
C
Q
R
v
V
m
"}
(10,1,1) = {"
m
Q
C
Q
Q
Q
C
Q
G
f
k
m
"}
(11,1,1) = {"
m
Q
C
Q
Q
Q
C
Q
r
b
A
m
"}
(12,1,1) = {"
m
Q
C
Q
Q
Q
C
Q
X
H
k
m
"}
(13,1,1) = {"
m
Q
p
Q
Q
Q
p
Q
J
E
c
m
"}
(14,1,1) = {"
m
Q
C
Q
Q
Q
O
Q
R
f
k
m
"}
(15,1,1) = {"
m
M
M
M
M
M
M
M
m
l
n
m
"}
(16,1,1) = {"
m
M
q
N
h
i
N
q
M
t
L
m
"}
